###########
#0.##.....#
#..#...#.##
##...###.##
##.##.##.##
#.#.......#
#.#.#.#...#
#.#.#...#.#
#..##....##
##.#.....f#
###########
