###########
#0.#......#
#.#......##
#..#...#..#
#.....##..#
#.##.#...f#
###########
