###########
#0##......#
#.........#
#.....#...#
###..#....#
##....#...#
##.#.#.##.#
#...##....#
#.##...#..#
##.....#.f#
###########
