###########
#0#.##..###
#...##....#
#...#.....#
#......##.#
##.###.##f#
###########
