###########
#0#...###.#
#....###.##
#..##..#.##
#..#.####.#
#.##...####
#........##
#...#.....#
#..#......#
#.#####..f#
###########
