###########
#0..##....#
#..#....#.#
#.......#.#
#..#......#
##........#
##.....##.#
#..#.##.#f#
###########
