###########
#0..###...#
#...#....##
#...#..##.#
#.......#.#
#.#...#..f#
###########
