###########
#0.#.##..##
#.#..#....#
#.#..#.##.#
#...#.#..##
#.#..#....#
#.#.....#.#
##....#.#.#
##...##.#.#
#.###....f#
###########
