###########
#0#.###...#
#..#.....##
#......#..#
#.#.#.#...#
#..##.#..f#
###########
