###########
#0......#.#
#...#..####
###.##....#
#...#.#...#
#..#......#
#.###.#...#
#..##...#.#
#...###..##
#........f#
###########
