#########
#0......#
#...##..#
#..#....#
###..#.##
#...#...#
###.##..#
#.#..#..#
##....###
#......f#
#########
