###########
#0#...###.#
#...#######
##...######
#.#...#..##
#.#...#...#
#.##....#.#
#.#....##f#
###########
