###########
#0..#....##
#...#.#..##
##.#..##.##
#..#...#..#
##...##...#
#.##.#..#.#
##.#..#..f#
###########
