###########
#0###.#...#
#.........#
#....#.#..#
##.....#..#
#..#.#.#.##
#.........#
##...##..f#
###########
