###########
#0.#.#....#
##..#####.#
#.........#
#......#..#
#.#.....#.#
#..#.#.#..#
###.###..f#
###########
