###########
#0.##...#.#
#..#....#.#
#.........#
#.....###.#
#...#.##..#
####.###..#
#.#.#.....#
#.....#...#
########.f#
###########
