#########
#0..#.#.#
#..####.#
#.....#.#
#.###.#.#
#.#..#..#
#..#....#
#.....###
##......#
##...##f#
#########
