###########
#0##..#..##
#....#...##
##.#..#..##
#....#....#
##..###.#.#
##.....#.##
##....#...#
###..#....#
#..#....#f#
###########
