###########
#0##.....##
#.#....#..#
#....##.#.#
#.........#
#......#.##
#..#####..#
##...##...#
#..#..##..#
##.##..#.f#
###########
