###########
#0..#.....#
#...####..#
##..##....#
##..#...#.#
###..#.#..#
#..#...#..#
#...###...#
#.#..###..#
###.#.#.#f#
###########
