#####
#0.f#
#...#
#...#
#####

