###########
#0....#..##
#....##.#.#
##........#
#....#....#
###...#..f#
###########
