###########
#0.##.#.###
#...#.....#
#.......#.#
#......#..#
#.#####..f#
###########
