###########
#0.#......#
#......#..#
#..#...##.#
###....##.#
#.#..#.##.#
###....#..#
#..#..###f#
###########
