###########
#0..####..#
#.....#...#
##...#..#.#
###.....#.#
#.##.####f#
###########
