###########
#0..##....#
#.........#
#......#.f#
###########
