###########
#0..##.####
#.......###
#....##...#
#......#.##
##.##.##..#
#..##.#...#
#....#...##
#...##..#.#
#...#....f#
###########
