###########
#0..##.#.##
#....#..#.#
#.........#
#.#....#..#
###..###.f#
###########
