###########
#0......###
#.#.....#.#
#.#..#...##
##.#.#....#
##......#f#
###########
