###########
#0......#.#
##..#...#.#
##....#..##
##...##...#
#.#.#.#..##
####......#
#...#..#..#
###.#.#.#.#
#..#####.f#
###########
