###########
#0.#....###
#...#....##
#......#.f#
###########
