#########
#0..#.#.#
#.......#
##....#f#
#########
