###########
#0#.#.#...#
#...#####.#
#..#.##..##
#..#......#
#......#.f#
###########
