###########
#0..#.##..#
#..###.##.#
#...#####.#
##....##..#
#.........#
#.#....#..#
##..##.#.f#
###########
