###########
#0#..###..#
#..#......#
#.....#..##
#......#..#
#.#...###.#
#.....###.#
###.#..#.f#
###########
