#########
#0...####
#...##.##
#.....#.#
#..##...#
#.....#f#
#########
