###########
#0#.#..#.##
#.#.##...##
#..#.#...##
#.##....###
#.##......#
#...#...#.#
#.......#.#
#.#..##.#.#
#..###.##f#
###########
