###########
#0#..###..#
#......#.##
#....#...##
#......#.##
#....#.#.##
###..###..#
#.#.##...f#
###########
