###########
#0####....#
#.#..#..#.#
#.#..##...#
#..#......#
#.....#..##
#..#.##...#
#....###.f#
###########
