###########
#0......#.#
#....#..#.#
##.###...f#
###########
