###########
#0..#.#.#.#
##........#
#......#.##
#.#.#.#...#
###.##..#.#
##.#....#.#
##.....#.##
#..#......#
##..#....f#
###########
