###########
#0..##....#
#...##...##
##..#.....#
#......#..#
##...##...#
#......#..#
##...#.##f#
###########
