###########
#0..#.....#
#......#..#
###...#.#.#
#.#..##...#
#...#....f#
###########
